“	「
”	」
‘	『
’	』
㐷	傌
㐹	㑶
㐽	偑
㑇	㑳
㑈	倲
㑔	㑯
㑩	儸
㓥	劏
㔉	劚
㖊	噚
㖞	喎
㘎	㘚
㚯	㜄
㛀	媰
㛟	𡞵
㛠	𡢃
㛣	㜏
㛤	孋
㛿	𡠹
㟆	㠏
㟜	𡾱
㤘	㥮
㧏	掆
㧐	㩳
㧑	撝
㧟	擓
㧰	擽
㨫	㩜
㭎	棡
㭏	椲
㭣	𣙎
㭤	樢
㭴	樫
㱩	殰
㱮	殨
㲿	瀇
㳔	濧
㳠	澾
㳡	濄
㳢	𣾷
㳽	瀰
㶉	鸂
㶶	燶
㶽	煱
㺍	獱
㻅	璯
㻏	𤫩
㻘	𤪺
䀥	䁻
䁖	瞜
䂵	碽
䃅	磾
䅉	稏
䅪	𥢢
䇲	筴
䉤	籔
䌶	䊷
䌷	紬
䌸	縳
䌹	絅
䌺	䋙
䌻	䋚
䌼	綐
䌽	綵
䌾	䋻
䌿	䋹
䍀	繿
䍁	繸
䎬	䎱
䏝	膞
䓖	藭
䗖	螮
䘛	𧝞
䘞	𧜗
䙊	𧜵
䙌	䙡
䙓	襬
䜣	訢
䜤	鿁
䜥	𧩙
䜧	䜀
䜩	讌
䝙	貙
䞌	𧵳
䞍	䝼
䞎	𧶧
䞐	賰
䟢	躎
䢀	𨊰
䢁	𨊸
䢂	𨋢
䥺	釾
䥽	鏺
䥾	䥱
䥿	𨯅
䦀	𨦫
䦁	𨧜
䦂	䥇
䦃	鐯
䦅	鐥
䦶	䦛
䦷	䦟
䭪	𩞯
䯃	𩣑
䯄	騧
䯅	䯀
䲝	䱽
䲞	𩶘
䲟	鮣
䲠	鰆
䲡	鰌
䲢	鰧
䲣	䱷
䲤	鿐
䴓	鳾
䴔	鵁
䴕	鴷
䴖	鶄
䴗	鶪
䴘	鷈
䴙	鷿
䶮	龑
与	與
专	專
业	業
丛	叢
东	東
丝	絲
丢	丟
两	兩
严	嚴
丧	喪
临	臨
为	為
丽	麗
举	舉
义	義
乌	烏
乐	樂
乔	喬
习	習
乡	鄉
书	書
买	買
乱	亂
争	爭
亏	虧
亚	亞
产	產
亩	畝
亲	親
亵	褻
亸	嚲
亿	億
仅	僅
从	從
仓	倉
仪	儀
们	們
众	眾
优	優
会	會
伛	傴
伞	傘
伟	偉
传	傳
伡	俥
伣	俔
伤	傷
伥	倀
伦	倫
伧	傖
伪	偽
伫	佇
体	體
佥	僉
侠	俠
侣	侶
侥	僥
侦	偵
侧	側
侨	僑
侩	儈
侪	儕
侬	儂
俣	俁
俦	儔
俨	儼
俩	倆
俪	儷
俫	倈
俭	儉
债	債
倾	傾
偬	傯
偻	僂
偾	僨
偿	償
傥	儻
傧	儐
储	儲
傩	儺
儿	兒
兑	兌
兖	兗
兰	蘭
关	關
兴	興
兹	茲
养	養
兽	獸
冁	囅
内	內
冈	岡
册	冊
写	寫
军	軍
农	農
冯	馮
决	決
况	況
冻	凍
净	淨
凉	涼
减	減
凑	湊
凛	凜
凤	鳳
凫	鳧
凭	憑
凯	凱
击	擊
凿	鑿
刍	芻
刘	劉
则	則
刚	剛
创	創
删	刪
刬	剗
刭	剄
刹	剎
刽	劊
刾	㓨
刿	劌
剀	剴
剂	劑
剐	剮
剑	劍
剥	剝
剧	劇
劝	勸
办	辦
务	務
劢	勱
动	動
励	勵
劲	勁
劳	勞
势	勢
勚	勩
匀	勻
匦	匭
匮	匱
区	區
医	醫
华	華
协	協
单	單
卖	賣
卢	盧
卧	臥
卫	衛
却	卻
厅	廳
厉	厲
压	壓
厌	厭
厍	厙
厐	龎
厕	廁
厢	廂
厣	厴
厦	廈
厨	廚
厩	廄
厮	廝
县	縣
叁	叄
叆	靉
叇	靆
双	雙
变	變
叙	敘
叠	疊
号	號
叽	嘰
吓	嚇
吕	呂
吗	嗎
吣	唚
听	聽
启	啟
吴	吳
呐	吶
呒	嘸
呓	囈
呕	嘔
呖	嚦
呗	唄
员	員
呙	咼
呛	嗆
呜	嗚
咏	詠
咙	嚨
咛	嚀
咝	噝
响	響
哑	啞
哒	噠
哓	嘵
哔	嗶
哕	噦
哙	噲
哜	嚌
哝	噥
哟	喲
唛	嘜
唝	嗊
唠	嘮
唡	啢
唢	嗩
唤	喚
啧	嘖
啬	嗇
啭	囀
啯	嘓
啰	囉
啴	嘽
啸	嘯
喷	噴
喽	嘍
喾	嚳
嗫	囁
嗳	噯
嘘	噓
嘤	嚶
嘱	囑
噜	嚕
嚣	囂
园	園
囱	囪
围	圍
囵	圇
国	國
图	圖
圆	圓
圣	聖
圹	壙
场	場
块	塊
坚	堅
坜	壢
坞	塢
坟	墳
坠	墜
垄	壟
垅	壠
垆	壚
垒	壘
垦	墾
垩	堊
垫	墊
垭	埡
垱	壋
垲	塏
埘	塒
埙	塤
埚	堝
堑	塹
堕	墮
塆	壪
墙	牆
壮	壯
声	聲
壳	殼
壶	壺
壸	壼
处	處
备	備
够	夠
头	頭
夺	奪
奁	奩
奂	奐
奋	奮
奖	獎
奥	奧
妆	妝
妇	婦
妈	媽
妩	嫵
妪	嫗
妫	媯
姗	姍
姹	奼
娄	婁
娅	婭
娆	嬈
娇	嬌
娈	孌
娱	娛
娲	媧
娴	嫻
婳	嫿
婴	嬰
婵	嬋
婶	嬸
媪	媼
媭	嬃
嫒	嬡
嫔	嬪
嫱	嬙
嬷	嬤
孙	孫
学	學
孪	孿
宁	寧
宝	寶
实	實
宠	寵
审	審
宪	憲
宫	宮
宽	寬
宾	賓
寝	寢
对	對
寻	尋
导	導
寿	壽
将	將
尔	爾
尘	塵
尧	堯
尴	尷
层	層
屃	屓
屉	屜
届	屆
属	屬
屡	屢
屦	屨
屿	嶼
岁	歲
岂	豈
岖	嶇
岗	崗
岘	峴
岚	嵐
岛	島
岽	崬
岿	巋
峃	嶨
峄	嶧
峡	峽
峣	嶢
峤	嶠
峥	崢
峦	巒
崂	嶗
崃	崍
崄	嶮
崭	嶄
嵘	嶸
嵚	嶔
嵝	嶁
巅	巔
巩	鞏
巯	巰
币	幣
帅	帥
师	師
帏	幃
帐	帳
帜	幟
带	帶
帧	幀
帮	幫
帱	幬
帻	幘
帼	幗
幂	冪
庆	慶
庐	廬
庑	廡
库	庫
应	應
庙	廟
庞	龐
废	廢
庼	廎
廪	廩
开	開
异	異
弃	棄
弑	弒
张	張
弪	弳
弯	彎
弹	彈
强	強
归	歸
录	錄
彟	彠
彦	彥
彨	彲
彻	徹
径	徑
徕	徠
忆	憶
忏	懺
忧	憂
忾	愾
怀	懷
态	態
怂	慫
怃	憮
怄	慪
怅	悵
怆	愴
总	總
怼	懟
怿	懌
恋	戀
恳	懇
恸	慟
恹	懨
恺	愷
恻	惻
恼	惱
恽	惲
悦	悅
悫	愨
悬	懸
悭	慳
悮	悞
悯	憫
惊	驚
惧	懼
惨	慘
惩	懲
惫	憊
惬	愜
惭	慚
惮	憚
惯	慣
愠	慍
愤	憤
愦	憒
慑	懾
懑	懣
懒	懶
懔	懍
戆	戇
戋	戔
戏	戲
戗	戧
战	戰
戬	戩
戯	戱
户	戶
执	執
扩	擴
扪	捫
扫	掃
扬	揚
扰	擾
抚	撫
抛	拋
抟	摶
抠	摳
抡	掄
抢	搶
护	護
报	報
担	擔
拟	擬
拢	攏
拣	揀
拥	擁
拦	攔
拧	擰
拨	撥
择	擇
挂	掛
挚	摯
挛	攣
挜	掗
挝	撾
挞	撻
挟	挾
挠	撓
挡	擋
挢	撟
挣	掙
挤	擠
挥	揮
挦	撏
捝	挩
捞	撈
损	損
捡	撿
换	換
捣	搗
掳	擄
掴	摑
掷	擲
掸	撣
掺	摻
掼	摜
揽	攬
揾	搵
揿	撳
搀	攙
搁	擱
搂	摟
搅	攪
携	攜
摄	攝
摅	攄
摆	擺
摇	搖
摈	擯
摊	攤
撄	攖
撑	撐
撵	攆
撷	擷
撸	擼
撺	攛
擞	擻
攒	攢
敌	敵
敛	斂
敩	斆
数	數
斋	齋
斓	斕
斩	斬
断	斷
无	無
旧	舊
时	時
旷	曠
旸	暘
昙	曇
昼	晝
昽	曨
显	顯
晋	晉
晒	曬
晓	曉
晔	曄
晕	暈
晖	暉
暂	暫
暧	曖
机	機
杀	殺
杂	雜
权	權
条	條
来	來
杨	楊
杩	榪
极	極
构	構
枞	樅
枢	樞
枣	棗
枥	櫪
枧	梘
枨	棖
枫	楓
枭	梟
柠	檸
柽	檉
栀	梔
栅	柵
标	標
栈	棧
栉	櫛
栊	櫳
栋	棟
栌	櫨
栎	櫟
栏	欄
树	樹
样	樣
栾	欒
桠	椏
桡	橈
桢	楨
档	檔
桤	榿
桥	橋
桦	樺
桧	檜
桨	槳
桩	樁
桪	樳
梦	夢
梼	檮
梾	棶
梿	槤
检	檢
棁	梲
棂	欞
椁	槨
椝	槼
椟	櫝
椠	槧
椢	槶
椤	欏
椫	樿
椭	橢
椮	槮
楼	樓
榄	欖
榅	榲
榇	櫬
榈	櫚
榉	櫸
槚	檟
槛	檻
槟	檳
槠	櫧
横	橫
樯	檣
樱	櫻
橥	櫫
橱	櫥
橹	櫓
橼	櫞
檩	檁
欢	歡
欤	歟
欧	歐
歼	殲
殁	歿
殇	殤
残	殘
殒	殞
殓	殮
殚	殫
殡	殯
殴	毆
毁	毀
毂	轂
毕	畢
毙	斃
毡	氈
毵	毿
氇	氌
气	氣
氢	氫
氩	氬
氲	氳
汉	漢
汤	湯
汹	洶
沟	溝
没	沒
沣	灃
沤	漚
沥	瀝
沦	淪
沧	滄
沨	渢
沩	溈
沪	滬
泞	濘
泪	淚
泶	澩
泷	瀧
泸	瀘
泺	濼
泻	瀉
泼	潑
泽	澤
泾	涇
洁	潔
浃	浹
浅	淺
浆	漿
浇	澆
浈	湞
浉	溮
浊	濁
测	測
浍	澮
济	濟
浏	瀏
浐	滻
浑	渾
浒	滸
浓	濃
浔	潯
浕	濜
涛	濤
涝	澇
涞	淶
涟	漣
涠	潿
涡	渦
涢	溳
涣	渙
涤	滌
润	潤
涧	澗
涨	漲
涩	澀
渊	淵
渌	淥
渍	漬
渎	瀆
渐	漸
渑	澠
渔	漁
渖	瀋
渗	滲
湾	灣
湿	濕
溃	潰
溅	濺
溆	漵
溇	漊
滗	潷
滚	滾
滞	滯
滟	灩
滠	灄
满	滿
滢	瀅
滤	濾
滥	濫
滦	灤
滨	濱
滩	灘
滪	澦
漤	灠
潆	瀠
潇	瀟
潋	瀲
潍	濰
潜	潛
潴	瀦
澛	瀂
澜	瀾
濑	瀨
濒	瀕
灏	灝
灭	滅
灵	靈
灾	災
灿	燦
炀	煬
炉	爐
炖	燉
炜	煒
炝	熗
点	點
炽	熾
烁	爍
烂	爛
烃	烴
烛	燭
烦	煩
烧	燒
烨	燁
烩	燴
烫	燙
烬	燼
热	熱
焕	煥
焖	燜
焘	燾
煴	熅
爱	愛
爷	爺
牍	牘
牦	氂
牵	牽
牺	犧
犊	犢
状	狀
犷	獷
犸	獁
犹	猶
狈	狽
狝	獮
狞	獰
独	獨
狭	狹
狮	獅
狯	獪
狰	猙
狱	獄
狲	猻
猃	獫
猎	獵
猕	獼
猡	玀
猪	豬
猫	貓
猬	蝟
献	獻
獭	獺
玑	璣
玙	璵
玚	瑒
玛	瑪
玮	瑋
环	環
现	現
玱	瑲
玺	璽
珐	琺
珑	瓏
珰	璫
珲	琿
琎	璡
琏	璉
琐	瑣
琼	瓊
瑶	瑤
瑷	璦
瑸	璸
璎	瓔
瓒	瓚
瓯	甌
电	電
画	畫
畅	暢
畴	疇
疖	癤
疗	療
疟	瘧
疠	癘
疡	瘍
疬	癧
疭	瘲
疮	瘡
疯	瘋
疱	皰
痈	癰
痉	痙
痖	瘂
痨	癆
痪	瘓
痫	癇
瘅	癉
瘆	瘮
瘗	瘞
瘘	瘺
瘪	癟
瘫	癱
瘾	癮
瘿	癭
癞	癩
癣	癬
癫	癲
皑	皚
皱	皺
皲	皸
盏	盞
盐	鹽
监	監
盖	蓋
盗	盜
盘	盤
眍	瞘
眦	眥
眬	矓
睁	睜
睐	睞
睑	瞼
瞆	瞶
瞒	瞞
瞩	矚
矫	矯
矶	磯
矾	礬
矿	礦
砀	碭
码	碼
砖	磚
砗	硨
砚	硯
砜	碸
砺	礪
砻	礱
砾	礫
础	礎
硁	硜
硕	碩
硖	硤
硗	磽
硙	磑
硚	礄
硵	磠
硷	鹼
碍	礙
碛	磧
碜	磣
碱	鹼
礼	禮
祃	禡
祎	禕
祢	禰
祯	禎
祷	禱
祸	禍
禀	稟
禄	祿
禅	禪
离	離
秃	禿
秆	稈
积	積
称	稱
秽	穢
秾	穠
稆	穭
税	稅
稣	穌
稳	穩
穑	穡
穷	窮
窃	竊
窍	竅
窎	窵
窑	窯
窜	竄
窝	窩
窥	窺
窦	竇
窭	窶
竖	豎
竞	競
笃	篤
笋	筍
笔	筆
笕	筧
笺	箋
笼	籠
笾	籩
筚	篳
筛	篩
筜	簹
筝	箏
筹	籌
筼	篔
简	簡
箓	籙
箦	簀
箧	篋
箨	籜
箩	籮
箪	簞
箫	簫
篑	簣
篓	簍
篮	籃
篯	籛
篱	籬
簖	籪
籁	籟
籴	糴
类	類
籼	秈
粜	糶
粝	糲
粤	粵
粪	糞
粮	糧
糁	糝
糇	餱
紧	緊
絷	縶
纟	糹
纠	糾
纡	紆
红	紅
纣	紂
纥	紇
约	約
级	級
纨	紈
纩	纊
纪	紀
纫	紉
纬	緯
纭	紜
纮	紘
纯	純
纰	紕
纱	紗
纲	綱
纳	納
纴	紝
纵	縱
纶	綸
纷	紛
纸	紙
纹	紋
纺	紡
纻	紵
纼	紖
纽	紐
纾	紓
线	線
绀	紺
绁	紲
绂	紱
组	組
绅	紳
细	細
织	織
终	終
绉	縐
绊	絆
绋	紼
绌	絀
绍	紹
绎	繹
经	經
绐	紿
绑	綁
绒	絨
结	結
绔	絝
绕	繞
绖	絰
绗	絎
绘	繪
给	給
绚	絢
绛	絳
络	絡
绝	絕
绞	絞
统	統
绠	綆
绡	綃
绢	絹
绤	綌
绥	綏
绦	絛
继	繼
绨	綈
绩	績
绪	緒
绫	綾
绬	緓
续	續
绮	綺
绯	緋
绰	綽
绱	鞝
绲	緄
绳	繩
维	維
绵	綿
绶	綬
绷	繃
绸	綢
绹	綯
绺	綹
绻	綣
综	綜
绽	綻
绾	綰
绿	綠
缀	綴
缁	緇
缂	緙
缃	緗
缄	緘
缅	緬
缆	纜
缇	緹
缈	緲
缉	緝
缊	縕
缋	繢
缌	緦
缍	綞
缎	緞
缏	緶
缐	線
缑	緱
缒	縋
缓	緩
缔	締
缕	縷
编	編
缗	緡
缘	緣
缙	縉
缚	縛
缛	縟
缜	縝
缝	縫
缞	縗
缟	縞
缠	纏
缡	縭
缢	縊
缣	縑
缤	繽
缥	縹
缦	縵
缧	縲
缨	纓
缩	縮
缪	繆
缫	繅
缬	纈
缭	繚
缮	繕
缯	繒
缰	韁
缱	繾
缲	繰
缳	繯
缴	繳
缵	纘
罂	罌
网	網
罗	羅
罚	罰
罢	罷
罴	羆
羁	羈
羟	羥
翘	翹
翙	翽
翚	翬
耢	耮
耧	耬
耸	聳
耻	恥
聂	聶
聋	聾
职	職
聍	聹
聩	聵
聪	聰
肃	肅
肠	腸
肤	膚
肾	腎
肿	腫
胀	脹
胁	脅
胆	膽
胧	朧
胨	腖
胪	臚
胫	脛
胶	膠
脉	脈
脍	膾
脐	臍
脑	腦
脓	膿
脔	臠
脚	腳
脱	脫
脶	腡
脸	臉
腘	膕
腭	齶
腻	膩
腼	靦
腽	膃
腾	騰
膑	臏
臜	臢
舆	輿
舣	艤
舰	艦
舱	艙
舻	艫
艰	艱
艺	藝
节	節
芈	羋
芗	薌
芜	蕪
芦	蘆
苁	蓯
苇	葦
苈	藶
苋	莧
苌	萇
苍	蒼
苎	苧
茎	莖
茏	蘢
茑	蔦
茔	塋
茕	煢
茧	繭
荆	荊
荙	薘
荚	莢
荛	蕘
荜	蓽
荝	萴
荞	蕎
荟	薈
荠	薺
荣	榮
荤	葷
荥	滎
荦	犖
荧	熒
荨	蕁
荩	藎
荪	蓀
荫	蔭
荬	蕒
荭	葒
荮	葤
莅	蒞
莱	萊
莲	蓮
莳	蒔
莴	萵
莶	薟
莸	蕕
莹	瑩
莺	鶯
莼	蓴
萚	蘀
萝	蘿
萤	螢
营	營
萦	縈
萧	蕭
萨	薩
葱	蔥
蒇	蕆
蒉	蕢
蒋	蔣
蒌	蔞
蓝	藍
蓟	薊
蓠	蘺
蓣	蕷
蓥	鎣
蓦	驀
蔂	虆
蔷	薔
蔹	蘞
蔺	藺
蔼	藹
蕰	薀
蕲	蘄
蕴	蘊
薮	藪
藓	蘚
蘖	櫱
虏	虜
虑	慮
虚	虛
虮	蟣
虽	雖
虾	蝦
虿	蠆
蚀	蝕
蚁	蟻
蚂	螞
蚃	蠁
蚕	蠶
蚬	蜆
蛊	蠱
蛎	蠣
蛏	蟶
蛮	蠻
蛰	蟄
蛱	蛺
蛲	蟯
蛳	螄
蛴	蠐
蜕	蛻
蜗	蝸
蝇	蠅
蝈	蟈
蝉	蟬
蝼	螻
蝾	蠑
螀	螿
螨	蟎
蟏	蠨
衅	釁
衔	銜
补	補
衬	襯
衮	袞
袄	襖
袅	裊
袆	褘
袜	襪
袭	襲
袯	襏
装	裝
裆	襠
裈	褌
裢	褳
裣	襝
裤	褲
裥	襉
褛	褸
褴	襤
襕	襴
见	見
观	觀
觃	覎
规	規
觅	覓
视	視
觇	覘
览	覽
觉	覺
觊	覬
觋	覡
觌	覿
觍	覥
觎	覦
觏	覯
觐	覲
觑	覷
觞	觴
触	觸
觯	觶
訚	誾
詟	讋
誉	譽
誊	謄
讠	訁
计	計
订	訂
讣	訃
认	認
讥	譏
讦	訐
讧	訌
讨	討
让	讓
讪	訕
讫	訖
讬	託
训	訓
议	議
讯	訊
记	記
讱	訒
讲	講
讳	諱
讴	謳
讵	詎
讶	訝
讷	訥
许	許
讹	訛
论	論
讻	訩
讼	訟
讽	諷
设	設
访	訪
诀	訣
诂	詁
诃	訶
评	評
诅	詛
识	識
诇	詗
诈	詐
诉	訴
诊	診
诋	詆
诌	謅
词	詞
诎	詘
诏	詔
诐	詖
译	譯
诒	詒
诓	誆
诔	誄
试	試
诖	詿
诗	詩
诘	詰
诙	詼
诚	誠
诛	誅
诜	詵
话	話
诞	誕
诟	詬
诠	詮
诡	詭
询	詢
诣	詣
诤	諍
该	該
详	詳
诧	詫
诨	諢
诩	詡
诪	譸
诫	誡
诬	誣
语	語
诮	誚
误	誤
诰	誥
诱	誘
诲	誨
诳	誑
说	說
诵	誦
诶	誒
请	請
诸	諸
诹	諏
诺	諾
读	讀
诼	諑
诽	誹
课	課
诿	諉
谀	諛
谁	誰
谂	諗
调	調
谄	諂
谅	諒
谆	諄
谇	誶
谈	談
谊	誼
谋	謀
谌	諶
谍	諜
谎	謊
谏	諫
谐	諧
谑	謔
谒	謁
谓	謂
谔	諤
谕	諭
谖	諼
谗	讒
谘	諮
谙	諳
谚	諺
谛	諦
谜	謎
谝	諞
谞	諝
谟	謨
谠	讜
谡	謖
谢	謝
谣	謠
谤	謗
谥	諡
谦	謙
谧	謐
谨	謹
谩	謾
谪	謫
谫	譾
谬	謬
谭	譚
谮	譖
谯	譙
谰	讕
谱	譜
谲	譎
谳	讞
谴	譴
谵	譫
谶	讖
豮	豶
贝	貝
贞	貞
负	負
贠	貟
贡	貢
财	財
责	責
贤	賢
败	敗
账	賬
货	貨
质	質
贩	販
贪	貪
贫	貧
贬	貶
购	購
贮	貯
贯	貫
贰	貳
贱	賤
贲	賁
贳	貰
贴	貼
贵	貴
贶	貺
贷	貸
贸	貿
费	費
贺	賀
贻	貽
贼	賊
贽	贄
贾	賈
贿	賄
赀	貲
赁	賃
赂	賂
赃	贓
资	資
赅	賅
赆	贐
赇	賕
赈	賑
赉	賚
赊	賒
赋	賦
赌	賭
赍	齎
赎	贖
赏	賞
赐	賜
赑	贔
赒	賙
赓	賡
赔	賠
赕	賧
赖	賴
赗	賵
赘	贅
赙	賻
赚	賺
赛	賽
赜	賾
赝	贗
赟	贇
赠	贈
赡	贍
赢	贏
赣	贛
赪	赬
赵	趙
赶	趕
趋	趨
趱	趲
趸	躉
跃	躍
跄	蹌
跞	躒
践	踐
跶	躂
跷	蹺
跸	蹕
跹	躚
跻	躋
踊	踴
踌	躊
踪	蹤
踬	躓
踯	躑
蹑	躡
蹒	蹣
蹰	躕
蹿	躥
躏	躪
躜	躦
躯	軀
车	車
轧	軋
轨	軌
轩	軒
轪	軑
轫	軔
转	轉
轭	軛
轮	輪
软	軟
轰	轟
轱	軲
轲	軻
轳	轤
轴	軸
轵	軹
轶	軼
轷	軤
轸	軫
轹	轢
轺	軺
轻	輕
轼	軾
载	載
轾	輊
轿	轎
辀	輈
辁	輇
辂	輅
较	較
辄	輒
辅	輔
辆	輛
辇	輦
辈	輩
辉	輝
辊	輥
辋	輞
辌	輬
辍	輟
辎	輜
辏	輳
辐	輻
辑	輯
辒	轀
输	輸
辔	轡
辕	轅
辖	轄
辗	輾
辘	轆
辙	轍
辚	轔
辞	辭
辩	辯
辫	辮
边	邊
辽	遼
达	達
迁	遷
过	過
迈	邁
运	運
还	還
这	這
进	進
远	遠
违	違
连	連
迟	遲
迩	邇
迳	逕
选	選
逊	遜
递	遞
逦	邐
逻	邏
遗	遺
遥	遙
邓	鄧
邝	鄺
邬	鄔
邮	郵
邹	鄒
邺	鄴
邻	鄰
郏	郟
郐	鄶
郑	鄭
郓	鄆
郦	酈
郧	鄖
郸	鄲
酂	酇
酝	醞
酦	醱
酱	醬
酽	釅
酾	釃
酿	釀
释	釋
銮	鑾
錾	鏨
钅	釒
钆	釓
钇	釔
针	針
钉	釘
钊	釗
钋	釙
钌	釕
钍	釷
钎	釺
钏	釧
钐	釤
钑	鈒
钒	釩
钓	釣
钔	鍆
钕	釹
钖	鍚
钗	釵
钘	鈃
钙	鈣
钚	鈈
钛	鈦
钜	鉅
钝	鈍
钞	鈔
钠	鈉
钡	鋇
钢	鋼
钣	鈑
钤	鈐
钥	鑰
钦	欽
钧	鈞
钨	鎢
钩	鈎
钪	鈧
钫	鈁
钬	鈥
钭	鈄
钮	鈕
钯	鈀
钰	鈺
钱	錢
钲	鉦
钳	鉗
钴	鈷
钵	缽
钶	鈳
钷	鉕
钸	鈽
钹	鈸
钺	鉞
钻	鑽
钼	鉬
钽	鉭
钾	鉀
钿	鈿
铀	鈾
铁	鐵
铂	鉑
铃	鈴
铄	鑠
铅	鉛
铆	鉚
铇	鉋
铈	鈰
铉	鉉
铊	鉈
铋	鉍
铌	鈮
铍	鈹
铎	鐸
铏	鉶
铐	銬
铑	銠
铒	鉺
铓	鋩
铔	錏
铕	銪
铖	鋮
铗	鋏
铘	鋣
铙	鐃
铚	銍
铛	鐺
铜	銅
铝	鋁
铞	銱
铟	銦
铠	鎧
铡	鍘
铢	銖
铣	銑
铤	鋌
铥	銩
铦	銛
铧	鏵
铨	銓
铩	鎩
铪	鉿
铫	銚
铬	鉻
铭	銘
铮	錚
铯	銫
铰	鉸
铱	銥
铳	銃
铴	鐋
铵	銨
银	銀
铷	銣
铸	鑄
铹	鐒
铻	鋙
铼	錸
铽	鋱
铿	鏗
销	銷
锁	鎖
锂	鋰
锃	鋥
锄	鋤
锅	鍋
锆	鋯
锇	鋨
锉	銼
锊	鋝
锋	鋒
锌	鋅
锍	鋶
锎	鐦
锏	鐧
锐	銳
锑	銻
锒	鋃
锓	鋟
锔	鋦
锕	錒
锖	錆
锗	鍺
锘	鍩
错	錯
锚	錨
锛	錛
锜	錡
锝	鍀
锞	錁
锟	錕
锠	錩
锡	錫
锢	錮
锣	鑼
锤	錘
锥	錐
锦	錦
锧	鑕
锨	杴
锩	錈
锪	鍃
锫	錇
锬	錟
锭	錠
键	鍵
锯	鋸
锰	錳
锱	錙
锲	鍥
锳	鍈
锴	鍇
锵	鏘
锶	鍶
锷	鍔
锸	鍤
锹	鍬
锺	鍾
锻	鍛
锼	鎪
锽	鍠
锾	鍰
锿	鎄
镀	鍍
镁	鎂
镂	鏤
镃	鎡
镄	鐨
镅	鎇
镆	鏌
镇	鎮
镈	鎛
镉	鎘
镊	鑷
镋	钂
镌	鐫
镍	鎳
镎	鎿
镏	鎦
镐	鎬
镑	鎊
镒	鎰
镓	鎵
镔	鑌
镕	鎔
镖	鏢
镗	鏜
镘	鏝
镙	鏍
镚	鏰
镛	鏞
镜	鏡
镝	鏑
镞	鏃
镟	鏇
镠	鏐
镡	鐔
镢	钁
镣	鐐
镤	鏷
镥	鑥
镦	鐓
镧	鑭
镨	鐠
镩	鑹
镪	鏹
镫	鐙
镬	鑊
镭	鐳
镮	鐶
镯	鐲
镱	鐿
镲	鑔
镳	鑣
镴	鑞
镵	鑱
镶	鑲
长	長
门	門
闩	閂
闪	閃
闫	閆
闬	閈
闭	閉
问	問
闯	闖
闰	閏
闱	闈
闳	閎
间	間
闵	閔
闶	閌
闷	悶
闸	閘
闹	鬧
闺	閨
闻	聞
闼	闥
闽	閩
闾	閭
闿	闓
阀	閥
阂	閡
阃	閫
阄	鬮
阅	閱
阆	閬
阇	闍
阈	閾
阉	閹
阊	閶
阋	鬩
阌	閿
阍	閽
阎	閻
阏	閼
阐	闡
阑	闌
阒	闃
阓	闠
阔	闊
阕	闋
阖	闔
阗	闐
阘	闒
阙	闕
阚	闞
阛	闤
队	隊
阳	陽
阴	陰
阵	陣
阶	階
际	際
陆	陸
陇	隴
陈	陳
陉	陘
陕	陝
陧	隉
陨	隕
险	險
随	隨
隐	隱
隶	隸
隽	雋
难	難
雏	雛
雠	讎
雳	靂
雾	霧
霁	霽
霡	霢
霭	靄
靓	靚
静	靜
靥	靨
鞑	韃
鞒	鞽
鞯	韉
韦	韋
韧	韌
韨	韍
韩	韓
韪	韙
韫	韞
韬	韜
韵	韻
页	頁
顶	頂
顷	頃
顸	頇
项	項
顺	順
顼	頊
顽	頑
顾	顧
顿	頓
颀	頎
颁	頒
颂	頌
颃	頏
预	預
颅	顱
领	領
颇	頗
颈	頸
颉	頡
颊	頰
颋	頲
颌	頜
颍	潁
颎	熲
颏	頦
颐	頤
频	頻
颒	頮
颓	頹
颔	頷
颕	頴
颖	穎
颗	顆
题	題
颙	顒
颚	顎
颛	顓
颜	顏
额	額
颞	顳
颟	顢
颠	顛
颡	顙
颢	顥
颣	纇
颤	顫
颥	顬
颦	顰
颧	顴
风	風
飏	颺
飐	颭
飑	颮
飒	颯
飓	颶
飔	颸
飕	颼
飖	颻
飗	飀
飘	飄
飙	飆
飚	飈
飞	飛
飨	饗
餍	饜
饣	飠
饤	飣
饦	飥
饧	餳
饨	飩
饩	餼
饪	飪
饫	飫
饬	飭
饭	飯
饮	飲
饯	餞
饰	飾
饱	飽
饲	飼
饳	飿
饴	飴
饵	餌
饶	饒
饷	餉
饸	餄
饹	餎
饺	餃
饻	餏
饼	餅
饽	餑
饾	餖
饿	餓
馀	餘
馁	餒
馂	餕
馃	餜
馄	餛
馅	餡
馆	館
馇	餷
馈	饋
馉	餶
馊	餿
馋	饞
馌	饁
馍	饃
馎	餺
馏	餾
馐	饈
馑	饉
馒	饅
馓	饊
馔	饌
馕	饢
马	馬
驭	馭
驮	馱
驯	馴
驰	馳
驱	驅
驲	馹
驳	駁
驴	驢
驵	駔
驶	駛
驷	駟
驸	駙
驹	駒
驺	騶
驻	駐
驼	駝
驽	駑
驾	駕
驿	驛
骀	駘
骁	驍
骂	罵
骃	駰
骄	驕
骅	驊
骆	駱
骇	駭
骈	駢
骉	驫
骊	驪
骋	騁
验	驗
骍	騂
骎	駸
骏	駿
骐	騏
骑	騎
骒	騍
骓	騅
骔	騌
骕	驌
骖	驂
骗	騙
骘	騭
骙	騤
骚	騷
骛	騖
骜	驁
骝	騮
骞	騫
骟	騸
骠	驃
骡	騾
骢	驄
骣	驏
骤	驟
骥	驥
骦	驦
骧	驤
髅	髏
髋	髖
髌	髕
鬓	鬢
鬶	鬹
魇	魘
魉	魎
鱼	魚
鱽	魛
鱾	魢
鱿	魷
鲀	魨
鲁	魯
鲂	魴
鲃	䰾
鲄	魺
鲅	鮁
鲆	鮃
鲇	鯰
鲈	鱸
鲉	鮋
鲊	鮓
鲋	鮒
鲌	鮊
鲍	鮑
鲎	鱟
鲏	鮍
鲐	鮐
鲑	鮭
鲒	鮚
鲓	鮳
鲔	鮪
鲕	鮞
鲖	鮦
鲗	鰂
鲘	鮜
鲙	鱠
鲚	鱭
鲛	鮫
鲜	鮮
鲝	鮺
鲞	鯗
鲟	鱘
鲠	鯁
鲡	鱺
鲢	鰱
鲣	鰹
鲤	鯉
鲥	鰣
鲦	鰷
鲧	鯀
鲨	鯊
鲩	鯇
鲪	鮶
鲫	鯽
鲬	鯒
鲭	鯖
鲮	鯪
鲯	鯕
鲰	鯫
鲱	鯡
鲲	鯤
鲳	鯧
鲴	鯝
鲵	鯢
鲷	鯛
鲸	鯨
鲹	鰺
鲺	鯴
鲻	鯔
鲼	鱝
鲽	鰈
鲾	鰏
鲿	鱨
鳀	鯷
鳁	鰮
鳂	鰃
鳃	鰓
鳄	鱷
鳅	鰍
鳆	鰒
鳇	鰉
鳈	鰁
鳉	鱂
鳊	鯿
鳋	鰠
鳌	鰲
鳍	鰭
鳎	鰨
鳏	鰥
鳐	鰩
鳑	鰟
鳒	鰜
鳓	鰳
鳔	鰾
鳕	鱈
鳖	鱉
鳗	鰻
鳘	鰵
鳙	鱅
鳚	䲁
鳛	鰼
鳜	鱖
鳝	鱔
鳞	鱗
鳟	鱒
鳠	鱯
鳡	鱤
鳢	鱧
鳣	鱣
鳤	䲘
鸟	鳥
鸠	鳩
鸡	雞
鸢	鳶
鸣	鳴
鸤	鳲
鸥	鷗
鸦	鴉
鸧	鶬
鸨	鴇
鸩	鴆
鸪	鴣
鸫	鶇
鸬	鸕
鸭	鴨
鸮	鴞
鸯	鴦
鸰	鴒
鸱	鴟
鸲	鴝
鸳	鴛
鸴	鷽
鸵	鴕
鸶	鷥
鸷	鷙
鸸	鴯
鸹	鴰
鸺	鵂
鸻	鴴
鸼	鵃
鸽	鴿
鸾	鸞
鸿	鴻
鹀	鵐
鹁	鵓
鹂	鸝
鹃	鵑
鹄	鵠
鹆	鵒
鹇	鷳
鹈	鵜
鹉	鵡
鹊	鵲
鹋	鶓
鹌	鵪
鹍	鵾
鹎	鵯
鹏	鵬
鹐	鵮
鹑	鶉
鹒	鶊
鹓	鵷
鹔	鷫
鹕	鶘
鹖	鶡
鹗	鶚
鹘	鶻
鹙	鶖
鹚	鶿
鹛	鶥
鹜	鶩
鹝	鷊
鹞	鷂
鹟	鶲
鹠	鶹
鹡	鶺
鹢	鷁
鹣	鶼
鹤	鶴
鹥	鷖
鹦	鸚
鹧	鷓
鹨	鷚
鹩	鷯
鹪	鷦
鹫	鷲
鹬	鷸
鹭	鷺
鹮	䴉
鹯	鸇
鹰	鷹
鹱	鸌
鹲	鸏
鹳	鸛
鹴	鸘
鹾	鹺
麦	麥
麸	麩
麹	麴
黄	黃
黉	黌
黡	黶
黩	黷
黪	黲
黾	黽
鼋	黿
鼍	鼉
鼗	鞀
鼹	鼴
齐	齊
齑	齏
齿	齒
龀	齔
龁	齕
龂	齗
龃	齟
龄	齡
龅	齙
龆	齠
龇	齜
龈	齦
龉	齬
龊	齪
龋	齲
龌	齷
龙	龍
龚	龔
龛	龕
龟	龜
鿎	䃮
鿏	䥑
鿒	鿓
鿔	鎶
𠆲	儣
𠆿	𠌥
𠉂	㒓
𠉗	𠏢
𠚳	𠠎
𠛅	剾
𠛆	𠞆
𠯟	哯
𠯠	噅
𠲥	𡅏
𠴢	𡄔
𠵸	𡄣
𠵾	㗲
𡋀	𡓾
𡋗	𡑭
𡒄	壈
𡝠	㜷
𡞱	㜢
𡭜	𡮉
𡭬	𡮣
𡶴	嵼
𢀖	巠
𢋈	㢝
𢘝	𢣚
𢘞	𢣭
𢙓	懀
𢛯	㦎
𢫊	𢷮
𢫞	𢶫
𢫬	摋
𢬦	𢹿
𢭏	擣
𢽾	斅
𣆐	曥
𣍨	𦢈
𣍯	腪
𣍰	脥
𣎑	臗
𣐤	欍
𣑶	𣠲
𣗋	欓
𣘓	𣞻
𣘴	檭
𣘷	𣝕
𣭤	𣯴
𣲗	湋
𣲘	潕
𣶩	澅
𣶫	𣿉
𣸣	濆
𣺼	灙
𣺽	𤁣
𣽷	瀃
𤆡	熓
𤇃	爄
𤇄	熌
𤈶	熉
𤈷	㷿
𤊀	𤒎
𤋏	熡
𤞤	玁
𤠋	㺏
𤦀	瓕
𤩽	瓛
𤳄	𤳸
𤶧	𤸫
𤽯	㿧
𤾀	皟
𥅘	𥌃
𥅴	䀹
𥆧	瞤
𥇢	䁪
𥐟	礒
𥐯	𥖅
𥐰	𥕥
𥐻	碙
𥧂	𥨐
𥬀	䉙
𥬞	籋
𥬠	篘
𥭉	𥵊
𥮋	𥸠
𥮜	䉲
𥱔	𥵃
𥹥	𥼽
𥺅	䊭
𥺇	𥽖
𦈈	𥿊
𦈉	緷
𦈋	綇
𦈌	綀
𦈎	繟
𦈏	緍
𦈐	縺
𦈑	緸
𦈒	𦂅
𦈓	䋿
𦈔	縎
𦈕	緰
𦈖	䌈
𦈗	𦃄
𦈘	䌋
𦈙	䌰
𦈚	縬
𦈛	繓
𦈜	䌖
𦈝	繏
𦈞	䌟
𦈟	䌝
𦈠	䌥
𦈡	繻
𦛨	朥
𦝼	膢
𦟗	𦣎
𦨩	𦪽
𦰴	䕳
𧉞	䗿
𧒭	𧔥
𧮪	詀
𧳕	𧳟
𧹑	䞈
𧹓	𧶔
𧹕	䝻
𧹖	賟
𧹗	贃
𧿈	𨇁
𨀱	𨄣
𨁴	𨅍
𨂺	𨈊
𨄄	𨈌
𨅫	𨇞
𨅬	躝
𨉗	軉
𨐅	軗
𨐆	𨊻
𨐇	𨏠
𨐈	輄
𨐉	𨎮
𨐊	𨏥
𨑹	䢨
𨤰	𨤻
𨰾	鎷
𨰿	釳
𨱀	𨥛
𨱁	鈠
𨱂	鈋
𨱃	鈲
𨱄	鈯
𨱅	鉁
𨱆	龯
𨱇	銶
𨱈	鋉
𨱉	鍄
𨱊	𨧱
𨱋	錂
𨱌	鏆
𨱍	鎯
𨱎	鍮
𨱏	鎝
𨱐	𨫒
𨱑	鐄
𨱒	鏉
𨱓	鐎
𨱔	鐏
𨱕	𨮂
𨱖	䥩
𨷿	䦳
𨸀	𨳕
𨸁	𨳑
𨸂	閍
𨸃	閐
𨸄	䦘
𨸅	𨴗
𨸆	𨵩
𨸇	𨵸
𨸉	𨶀
𨸊	𨶏
𨸋	𨶲
𨸌	𨶮
𨸎	𨷲
𨸘	𨽏
𨸟	䧢
𩏼	䪏
𩏽	𩏪
𩏾	𩎢
𩏿	䪘
𩐀	䪗
𩖕	𩓣
𩖖	顃
𩖗	䫴
𩙥	颰
𩙦	𩗀
𩙧	𩗡
𩙨	𩘹
𩙩	𩘀
𩙪	颷
𩙫	颾
𩙬	𩘺
𩙭	𩘝
𩙮	䬘
𩙯	䬝
𩙰	𩙈
𩟿	𩚛
𩠀	𩚥
𩠁	𩚵
𩠂	𩛆
𩠃	𩛩
𩠅	𩟐
𩠆	𩜦
𩠇	䭀
𩠈	䭃
𩠉	𩜇
𩠊	𩜵
𩠋	𩝔
𩠌	餸
𩠎	𩞄
𩠏	𩞦
𩠠	𩠴
𩧦	𩡺
𩧨	駎
𩧩	𩤊
𩧪	䮾
𩧫	駚
𩧬	𩢡
𩧭	䭿
𩧮	𩢾
𩧯	驋
𩧰	䮝
𩧱	𩥉
𩧲	駧
𩧳	𩢸
𩧴	駩
𩧵	𩢴
𩧶	𩣏
𩧺	駶
𩧻	𩣵
𩧼	𩣺
𩧿	䮠
𩨀	騔
𩨁	䮞
𩨃	騝
𩨄	騪
𩨅	𩤸
𩨆	𩤙
𩨇	䮫
𩨈	騟
𩨉	𩤲
𩨊	騚
𩨋	𩥄
𩨌	𩥑
𩨍	𩥇
𩨎	龭
𩨏	䮳
𩨐	𩧆
𩬣	𩭙
𩬤	𩰀
𩯒	𩯳
𩲒	𩳤
𩽹	魥
𩽺	𩵩
𩽻	𩵹
𩽼	鯶
𩽽	𩶱
𩽾	鮟
𩽿	𩶰
𩾁	鯄
𩾂	䲖
𩾃	鮸
𩾄	𩷰
𩾅	𩸃
𩾆	𩸦
𩾇	鯱
𩾈	䱙
𩾊	䱬
𩾋	䱰
𩾌	鱇
𩾎	𩽇
𪉂	䲰
𪉃	鳼
𪉄	𩿪
𪉅	𪀦
𪉆	鴲
𪉈	鴜
𪉉	𪁈
𪉊	鷨
𪉋	𪀾
𪉌	𪁖
𪉍	鵚
𪉎	𪂆
𪉏	𪃏
𪉐	𪃍
𪉑	鷔
𪉒	𪄕
𪉓	𪈼
𪉔	𪄆
𪉕	𪇳
𪎈	䴬
𪎉	麲
𪎊	麨
𪎋	䴴
𪎌	麳
𪎍	𪋿
𪔭	𪔵
𪚏	𪘀
𪚐	𪘯
𪞝	凙
𪟝	勣
𪡏	嗹
𪢮	圞
𪣻	塿
𪨊	㞞
𪨗	屩
𪨶	輋
𪩘	巘
𪻐	瑽
𪾢	睍
𫁡	鴗
𫂈	䉬
𫄧	綖
𫄨	絺
𫄷	繶
𫄸	纁
𫇭	蒍
𫌀	襀
𫌨	覼
𫍙	訑
𫍢	譊
𫍣	詷
𫍯	諴
𫍰	諰
𫍲	謏
𫍽	譞
𫏋	蹻
𫐄	軏
𫐆	轣
𫐉	軨
𫐐	輗
𫐓	輮
𫑡	鄳
𫓧	鈇
𫓩	鏦
𫓯	銈
𫓶	鋗
𫓹	錤
𫔍	鐇
𫔎	鐍
𫔶	闑
𫖮	顗
𫖯	頫
𫖳	頵
𫖸	願
𫗠	餦
𫗦	餔
𫗧	餗
𫗮	餭
𫗴	饘
𫘜	馼
𫘝	駃
𫘣	駻
𫘤	騃
𫘦	騊
𫘧	騄
𫘨	騠
𫘪	騵
𫘬	騱
𫚈	鱮
𫚉	魟
𫚒	鮄
𫚔	鮰
𫚕	鰤
𫚖	鮆
𫚙	鯆
𫚭	鱲
𫛛	鳷
𫛞	鴃
𫛢	鸋
𫛭	鵟
𫛶	鶒
𫛸	鶗
𫞩	璊
𫟅	綡
𫟦	䡵
𫟷	鉝
𫟹	鉷
𫟼	鐽
𫠆	頍
𫠊	䮄
𫠜	齯
𫢸	僤
𫫇	噁
𫭟	塸
𫭢	埨
𫭼	𡑍
𫮃	墠
𫰛	娙
𫵷	㠣
𫶇	嵽
𫷷	廞
𫸩	彄
𬀩	暐
𬀪	晛
𬂩	梜
𬃊	櫍
𬇕	澫
𬇙	浿
𬇹	漍
𬉼	熰
𬊈	燖
𬊤	燀
𬍛	瓅
𬍡	璗
𬍤	璕
𬒈	礐
𬒗	𥗽
𬕂	篢
𬘓	紃
𬘘	紞
𬘡	絪
𬘩	綎
𬘫	綄
𬘬	綪
𬘭	綝
𬘯	綧
𬙂	縯
𬙊	纆
𬙋	纕
𬜬	蔄
𬜯	䓣
𬟁	虉
𬟽	蝀
𬣙	訏
𬣞	詝
𬣡	諓
𬣳	詪
𬤇	諲
𬤊	諟
𬤝	譓
𬨂	軝
𬨎	輶
𬩽	鄩
𬪩	醲
𬬩	釴
𬬭	錀
𬬮	鋹
𬬱	釿
𬬸	鉥
𬬹	鉮
𬬻	鑪
𬬿	鉊
𬭁	鉧
𬭊	𨧀
𬭎	鋐
𬭚	錞
𬭛	𨨏
𬭤	鍭
𬭩	鎓
𬭬	鏏
𬭯	䥕
𬭳	𨭎
𬭶	𨭆
𬭸	鏻
𬭼	鐩
𬮱	闉
𬮿	隑
𬯀	隮
𬯎	隤
𬱖	頔
𬱟	頠
𬳵	駓
𬳶	駉
𬳽	駪
𬳿	駼
𬴂	騑
𬴃	騞
𬴊	驎
𬶋	鮈
𬶍	鮀
𬶏	鮠
𬶐	鮡
𬶟	鯻
𬶠	鰊
𬶨	鱀
𬶭	鰶
𬶮	鱚
𬷕	鵏
𬸘	鶠
𬸚	鸑
𬸣	鶱
𬸦	鷟
𬸪	鷭
𬹼	齘
𬺈	齮
𬺓	齼
漓	灕
瓮	甕
𬞟	蘋
痹	痺
泄	泄洩
万	万萬
丑	丑醜
个	個箇
丰	丰豐
么	么麼
了	了瞭
于	于於
云	云雲
仆	仆僕
仑	侖崙
价	价價
伙	伙夥
余	余餘
佣	佣傭
借	借藉
克	克剋
党	党黨
冬	冬鼕
冲	冲沖衝
凄	悽淒
准	准準
几	几幾
凶	兇凶
出	出齣
划	划劃
别	別彆
刮	刮颳
制	制製
勋	勛勳
千	千韆
升	升昇陞
卜	卜蔔
占	佔占
卤	滷鹵
卷	卷捲
厂	厂廠
历	厤曆歷
厘	厘釐
参	參蔘
发	發髮
只	只隻
台	台檯臺颱
叶	叶葉
叹	嘆
吊	吊弔
后	后後
向	向嚮
吨	吨噸
周	周週
哄	哄鬨
哗	嘩譁
啮	嚙囓齧
喂	喂餵
噪	噪譟
回	回迴
团	團糰
困	困睏
坏	坏壞
坛	壇罈
坝	垻壩
复	復複覆
夸	夸誇
夹	夾袷
奸	奸姦
家	傢家
尝	嘗
尸	尸屍
尽	儘盡
局	侷局跼
岩	岩巖
岭	岭嶺
岳	岳嶽
峰	峯峰
帘	帘簾
席	席蓆
干	乾干幹榦
并	並併并
幸	倖幸
广	广廣
庄	庄莊
弥	彌瀰
当	噹當
征	征徵
御	御禦
志	志誌
怜	怜憐
恒	恆恒
恶	噁惡
愿	愿願
扎	扎紮
扑	扑撲
托	托託
折	折摺
抵	抵牴
据	据據
斗	斗鬥
暗	暗闇
曲	曲麴
术	朮術
朱	朱硃
朴	朴樸
杠	杠槓
杯	杯盃
杰	傑杰
松	松鬆
板	板闆
枪	槍鎗
柜	柜櫃
栖	栖棲
栗	慄栗
梁	梁樑
欲	慾欲
汇	匯彙滙
沈	沈瀋
注	注註
洒	洒灑
洼	洼窪
涂	塗涂
涌	涌湧
淀	淀澱
淡	淡澹
温	温溫
游	游遊
溪	溪谿
澄	澂澄
灯	灯燈
炼	煉鍊
烟	煙菸
痒	痒癢
痳	痲痳
着	着著
确	确確
秋	秋鞦
种	种種
筑	筑築
签	簽籤
系	係系繫
纤	縴纖
练	練鍊
绣	綉繡
羡	羡羨
联	联聯
肮	肮骯
肴	肴餚
胜	勝胜
胡	胡鬍
脏	臟髒
腊	腊臘
腌	腌醃
致	緻致
舍	捨舍
艳	艷豔
芸	芸蕓
苏	囌甦蘇
苧	苧薴
范	範范
荐	荐薦
荡	盪蕩
药	葯藥
获	獲穫
蒙	朦濛矇蒙
虫	虫蟲
蜡	蜡蠟
蝎	蝎蠍
表	表錶
证	証證
谷	穀谷
赞	讚贊
辟	辟闢
迹	跡蹟
适	适適
郁	郁鬱
采	寀採采
里	裡里
鉴	鑑鑒
钟	鍾鐘
铲	剷鏟
铺	舖鋪
链	鍊鏈
锈	銹鏽
镰	鎌鐮
闲	閑閒
阁	閣閤
雕	雕鵰
霉	霉黴
面	面麵
须	須鬚
饥	飢饑
鹅	鵝鵞
吁	吁籲
仇	仇讎
僵	僵殭
冢	冢塚
咚	咚鼕
咨	咨諮
咸	咸鹹
姜	姜薑
愈	愈癒
挽	挽輓
捆	捆綑
昆	昆崑
昵	昵暱
札	札劄
杆	杆桿
苹	苹蘋
逾	逾踰
雇	雇僱
沾	沾霑
胄	胄冑
冑	胄冑
蔑	蔑衊
累	累纍
象	象像
